
NO textures/Asset-1.xpm
SO textures/Asset-6.xpm


C   50,50,50


EA textures/Asset-3.xpm

ZO textures/enemy.xpm

WE textures/Asset-8.xpm

F 150,150,150

1111
11001
1Z0001
1000Z01
1N0001
111101
111101
1111Z1
   111
