
NO textures/Asset-6.xpm
SO textures/Asset-6.xpm

DO  textures/Door_Sliding_128x128.xpm
ZO  textures/enemy.xpm

C  35,40,45

ON textures/shotgun_buy.xpm

EA textures/Asset-6.xpm


WE textures/Asset-6.xpm

TW textures/ar_buy.xpm
F 35,30,30

1O1T1
10D01
Z0N01
11111
