
NO textures/Asset-6.xpm
SO textures/Asset-6.xpm

DO  textures/Door_Sliding_128x128.xpm
ZO  textures/enemy.xpm

C  35,40,45

ON textures/shotgun_buy.xpm

EA textures/Asset-6.xpm


WE textures/Asset-6.xpm

TW textures/ar_buy.xpm
F 35,30,30


11111111O1111111
T00000D00000000Z
1110001111001111
  11D11 11001
  100011100011111
  10S000000000001
  1000000Z0000001
  100000000000001
  111111111111111
