
NO textures/Asset-6.xpm
SO textures/Asset-6.xpm

DO  textures/Door_Sliding_128x128.xpm
ZO  textures/enemy.xpm

C  35,40,45

ON textures/shotgun_buy.xpm

EA textures/Asset-6.xpm


WE textures/Asset-6.xpm

TW textures/ar_buy.xpm
F 35,30,30

11Z11Z1111Z1111Z111Z1111Z11111
100000000000000000000000000001
10000000000000000000000000000Z
100000000000000000000000000001
100000000000000000000000000001
T0000000000000000000000000000Z
10E000000000000000000000000001
100000000000000000000000000001
1111O1111111111111111111111111
